NO ./textures/no_texture.xpm
SO ./textures/so_texture.xpm
WE ./textures/we_texture.xpm
EA ./textures/ea_texture.xpm   

F 200,0,0
C 0,150,200

  1111111
  10000001
 100000111 
  10N0001 
 1000001 
111111111
   1
1111
1001
1111