NO ./textures/no_texture.xpm
SO ./textures/so_texture.xpm
WE ./textures/we_texture.xpm
EA ./textures/ea_texture.xpm

F 200,200,200
C 100,100,100

  1111111    1111
 100000111   1001
  10N0001   1001
 1000001    1001
111111111   1111
